00000111
01110101
01011101
01100001
30110201
10010101
10010111
11110000