21111111
11111111
11111111
00011111
31011111
11000041
40001110
11111111