31111111
11111111
11111111
11111111
10010011
10111111
10110000
10141112