31111111
11111111
11111111
11111111
11111111
10111111
10110000
10111121